F 220,100,0
C 225,30,0

   11111111111
   10001 10001
11110001 10001
10000000100001
10000000000001
111111111000011111
   100000000S00001
   111111111111111