                         NO      ./textures/colorstone.png


        SO        ./textures/greystone.png
  WE ./textures/bluestone.png

  
EA ./textures/redbrick.png

 F     0,         0,      0


        C   255,          255,       255

        1111111111111111111111111
        1000000000110000000000001
        1011000001110000000000001
        1001000000000000000000001
111111111011000001110000000000001
100000000010000011100011111111111
11110111111111011100000010001
11110111111111011101010010001
11000000110101011100100010001
10000000000000000000000000001
10000N00000000001101010010001
11000001110101011111011110001
11111110111010111011110100011
1111111111111111 111111111111