NO      ./textures/yellow_wall.png
SO ./textures/green_wall.png
WE ./textures/blue_wall.png
EA ./textures/brick_wall.png

F 220,100,0
C 225,30,0

111111111111111111111111111111
100000000000000000000000000001
100000000000000000000000000001
100000000000000000000000000001
100000000000000000000000000001
100000000000000000000000000001
100000000000000000N00000000001
100000000000000000000000000001
100000000000000000000000000001
100000000000000000000000000001
100000000000000000000000000001
100000000000000000000000000001
111111111111111111111111111111